[1][1][1][1][1][1][1][1][1][1][1][1][1][1][1][1][1][1][1][1][1][1][1][1][1][1][1][1][1][1][1][1][1][1][1][1][1][1][1][1]
[1][1][11][11][11][11][11][11][11][11][11][11][11][11][11][11][1][11][11][11][11][11][11][11][11][11][11][11][11][11][11][11][11][11][11][11][11][11][1][1]
[1][3][0][0][0][0][0][0][0][0][0][0][0][0][0][0][4][0][0][0][0][0][0][0][0][0][0][0][0][0][0][0][0][0][0][0][0][0][4][1]
[1][3][0][0][0][0][51][51][51][0][0][0][0][53][53][14][4][0][0][0][0][0][0][0][0][0][0][0][0][0][0][0][0][0][0][0][0][0][4][1]
[1][1][2][2][2][2][2][2][2][9][2][2][2][2][2][2][1][0][0][0][0][0][0][0][0][0][0][0][0][0][0][0][0][0][0][0][0][0][4][1]
[1][3][0][0][0][0][0][0][0][9][0][0][0][0][0][0][4][0][0][0][0][0][0][0][0][0][0][0][0][0][0][0][0][0][0][0][0][0][4][1]
[1][3][0][0][0][0][0][0][0][9][0][0][0][0][0][0][4][0][0][0][0][0][0][0][0][0][0][0][0][0][0][0][0][0][0][0][0][0][4][1]
[1][3][14][53][53][0][0][0][0][9][0][0][0][0][0][0][4][0][0][0][0][0][0][0][0][0][0][0][0][0][0][0][0][0][0][0][0][0][4][1]
[1][1][2][2][2][2][2][2][2][9][2][2][2][2][2][2][1][0][0][0][0][0][0][0][0][0][0][0][0][0][0][0][0][0][0][0][0][0][4][1]
[1][3][0][0][0][0][0][0][0][9][0][0][0][0][0][0][4][0][0][0][0][0][0][0][0][0][0][0][0][0][0][0][0][0][0][0][0][0][4][1]
[1][3][0][0][0][0][0][0][0][9][0][0][0][0][0][0][4][0][0][0][0][0][0][0][0][0][0][0][0][0][0][0][0][0][0][0][0][0][4][1]
[1][3][0][0][0][0][0][0][0][9][0][0][0][53][53][14][4][0][0][0][0][0][0][0][0][0][0][0][0][0][0][0][0][0][0][0][0][0][4][1]
[1][1][2][2][2][2][2][2][2][9][2][2][2][2][2][2][1][0][0][0][0][0][0][0][0][0][0][0][0][0][0][0][0][0][0][0][0][0][4][1]
[1][3][0][0][0][0][0][0][0][9][0][0][0][0][0][0][0][0][0][0][0][0][0][0][0][0][0][0][0][0][0][0][0][0][0][0][0][0][4][1]
[1][3][0][0][0][0][0][0][0][9][0][0][0][0][0][0][0][0][0][0][0][0][0][0][0][0][0][0][0][0][0][0][0][98][99][98][0][0][4][1]
[1][3][0][0][0][0][0][0][0][9][0][0][0][0][0][0][0][0][0][0][0][0][0][0][0][0][0][2][2][2][2][2][2][2][2][2][2][2][1][1]
[1][3][0][0][0][0][0][0][0][9][0][0][0][0][0][0][0][0][0][0][0][0][2][2][2][2][2][1][1][1][1][1][1][1][1][1][1][1][1][1]
[1][3][14][53][53][0][0][0][0][9][0][0][0][0][0][0][0][2][2][2][2][2][1][1][1][1][1][1][1][1][1][1][1][1][1][1][1][1][1][1]
[1][1][2][2][2][2][2][2][2][2][2][2][2][2][2][2][2][1][1][1][1][1][1][1][1][1][1][1][1][1][1][1][1][1][1][1][1][1][1][1]
[1][1][1][1][1][1][1][1][1][1][1][1][1][1][1][1][1][1][1][1][1][1][1][1][1][1][1][1][1][1][1][1][1][1][1][1][1][1][1][1]
